TILEMAP
71 57                           -- Size of tile map in tiles
20 15                           -- Size of room
10 -7.5 18.1                    -- Camera Center
17 14                           -- Camera Movement
5 6 0                           -- Player First CheckPoint
2 models/cube10.obj 	          -- Style (0 = original, 1 = water, 2 = box, 3 = mario, 4 = minecraft)
11111111111111111111111111111111111111111111111111111111111111111111111
11111111111111111111111111111111111 11111111111111111111111111111111111
11u              t11111111111111111 11111111111111111111111111111111111
11u              t11       1                       111             t111
11u              t11                               sss             t111
11u                                                                t111
111                                     xxx                        1111
111$                               v    xcx                        1111
111                                     xxx                        t111
11u                                                rrr             t111
11u              t11                               111             t111
11u              t11       1                       111             t111
11u              t11111111111111111 11111111111111111111111    11111111
11111111111111111111111111111111111 11111111111111111111111    11111111
11111111111111111111111111111111111111111111111111111111111    11111111
                                                   11111111    11111111
                                                   11111111    11111111
                                                   11111111    11111111
                                                   111111        111111
                                                   111111  xxx   111111
                                                   111111  xcx   111111
                                                   111111  xxx   111111
                                                   111111        111111
                                                   11111111    11111111
                                                   11111111    11111111
                                                   11111111    11111111
                                                   11111111    11111111
                                                   11111111    11111111
                                                   11111111    11111111
                                                   11111111    11111111
                                                   11111111    11111111
                                                   11111111    11111111
                                                   11111111    11111111
                                                   11111111    11111111
                                                   11111111    11111111
                                                   11111111    11111111
                                                   11111111    11111111
                                                   11111111    11111111
                                                   11111111    11111111
                                                   1111            1111
                                                   1111     O      1111
                                                   1111            1111
                 111111111111111111111111111111111111111111    11111111
                 11111111111111111111 D 1111111111111111111    11111111
                 11               111                1                1
                 11                                         xxx       1
                 11                                         xcx       1
                 11                                         xxx       1
                 11                                  1                1
                 11       1111111111111111111111111111111111111111    1
                 11       1111111111111111111111111111111111111111    1
                 112jjqjj311               n            -             1
                 11       1111111111111111111111111111111111111111    1
                 11   f   11   11111111111111111111111111111111111    1
                 11       11 k                                        1
                 11       11                                          1
                 111111111111111111111111111111111111111111111111111111