TILEMAP
90 70                           -- Size of tile map in tiles
32 24                           -- Size of room
16 -35 29                       -- Camera Center
29 23                           -- Camera Movement
1 34 0                          -- Player First CheckPoint
1                               -- Style
                             1111111111111111111111111111111111111111111111111111111111111
                             1 1                                                         1
                             1 1         1111111111111111111111111111111111111111111     1
             111111          1 1         1                                         1     1
            11    11                     1                                         1     1
           11      11                    1                                         1     1
           1        1111111111111111111  1                                         1     1
           1            d             1  1              11111111                   1     1
           1   f        d             1  1              1      1        o          1     1
           1        111111111111s     1  1              1      1                   1     1
           11      11          1      1  1              1      1                   1     1
            11    11           1      1  1              1      1                   1     1
             111111            1      1  1              1      1        xxx        1     1
                               1      1  1              1      1        xcx        1     1
                               1      1  1              1      1        xxx        1     1
                               1      1111              1      1                   1     1
     1111111111111111111111    1                        1      111111         111111     1
     1   k     k     k    1    1                        1           1    m    1          1
     1                    1    1                        1           1    m    1          1
     1                   k1    11111111111111111111111111           1    m    1          1
     1                    1                                         111  m  111          1
     1111111111  1111111111                                              m               1
              1  1                                                       m               1
              1  1                                                       m               1
              1  1                                                       m               1
              1  1                                                       m               1
              1  1                                                       m               1
              1  1                   11111111111111                      m               1
              1 k1                   1ssssssssssss1                      m               1
        1111111dd1111111             1      -     1                      m               1
        1s             1             1            1                      m               1
        1              1             1            1                      m               1
        1              1             1            1                      m               1
111111111              111111111111111    xxx     1                      m               1
1                      d                  xcx     1                      m               1
1                      d                  xxx     1                      m               1
111111111              111111111111111            1                      m               1
        1              1             1            1                      m               1
        1              1             1            1                      m               1
        1             k1             1            1                      m               1
        1111111  1111111             1            1                      m               1
              1  1                   1   h        1                      m               1
              1  1                   1sssssssss   1                      m               1
              1  1                   11111111111  1                      m               1
              1  1                             1  1                      m               1
              1  1                             1  1                      m               1
111111111111111  111111111111111               1  1                      m              11
1       1     1  1             1               1  1                      m               1
1       1     1  1             1               1  1                      m               1
1  111  1111  1  1  11111111   1    111111111111  111111111              m               1
1  1       1  1  1  1     11   1    1                    s1              m               1
1  1       1  1  1       111   1    1                    s1              m               1
1  111111  1     1      1111   1    1                   11111111111      m               1
1  1    1  1     1  1  11111   1    1s                           s1      m               1
1       1  1111  1  1  1111   11    1s                           s1      m               1
1       1     1  1  1  111    11    1                   11111111111      m               1
1  111  1     1     1  1     111    1                    s1              m               1
1  1    1111  1     1      11111    1                    s1              m               1
1  1       1  1  1111    1111111    1                  v s1              m               1
1  1       1  1  1     111111111    1                    s1              m               1
1  11111   1     1    1111  1111    1                   11111111111      m               1
1   1      1     1  11111     11    1s                                   m               1
1   1      1111  1  111        1    1s                                   m               1
1   111  111111  1        111  1    1                   11111111111      m               1
1     1  111111dd11     111    1    1                    s1              m               1
1     1  11111    1111111     11    1                    s1              m               1
1   111        k            111     11111111111111111111111                              1
1                         111                                                            1
1   1111111111    111111111                                                              1
11111        111111            11111111111111111111111111111111111111111111111111111111111