TILEMAP
71 57                           -- Size of tile map in tiles
20 15                           -- Size of room
27 -21.5 18.1                    -- Camera Center
17 14                           -- Camera Movement
5 6 0                           -- Player First CheckPoint
4 models/cube10.obj 	        -- Style (0 = original, 1 = water, 2 = box, 3 = mario, 4 = minecraft)
                11111111111111111111111111111111111111                 
                11111111111111111111111111      111111                 
                1111111111111   1111111           1111                 
                1111111111         111              11                 
                11111111            1               11                 
                1111111                              1                 
                111111                     xxx       1                 
                111111                     xcx       1                 
                111111                     xxx       1                 
                11111                               11                 
                11111                               11                 
                1111                11             111                 
                1111               1111           1111                 
                1111               11111        111111                 
                1111      H       11111111    11111111                 
                u                    tu          tu                    
                u                    tu          tu                    
                u                    tu          tu                    
                u                    tu          tu                    
                u                    tu          tu                    
                u|                  |tu|        |tu                    
                u                    tu          tu                    
                u         $          tu          tu                    
                u                    tu          tu                    
                u                    tu          tu                    
                u                    tu          tu                    
                u                    tu          tu                    
                u                    tu          tu                    
                1111     -        111111        111111                 
                1111rrrrrrrrrrrrrr1tu             L111                 
                                  1tu              tu1                 
                                  1tu              tu1                 
                                  1tu              tu1                 
                                  1tu              tu1                 
                                  1tu              tu1                 
                                  1tuv            vtu1                 
                                  1tu              tu1                 
                                  1tu              tu1                 
                                  1tu              tu1                 
                                  1tu              tu1                 
                                  1tu              tu1                 
                                  111rrrrrn  nrrrrr111                 
1111111111111111111111111111111111111sssssn  nsssss111                 
111       1111111111111         1111111111n  n11111111                 
11          1111111111            11111111n  n11111111                 
1            11111sss1             1111111n  n11111111                 
1            11111   11  1          111111n  n11111111                 
1             1111   11  111         11111n  n11111111                 
1             1111 o 11  11111        1111n  n11111111                 
1nnnnn11      1111 k 11  1111111                111111                 
1     11      1111   11  111111111                6111                 
1     11      1111   11  1111111111       xxx     7  1                 
1     11      1111   11  11111111111      xcx     8 L1                 
1  f  11       111   1   111111111111     xxx     7  1                 
11   1111                111111111111             9111                 
111 111111              1111111111111111        111111                 
111111111111111111111111111111111111111111111111111111                 