TILEMAP
90 70                           -- Size of tile map in tiles
32 24                           -- Size of room
16 -12 29                     -- Camera Center
29 23                           -- Camera Movement
5 6 0                           -- Player First CheckPoint
1                              -- Number of models
1 models/cube10.obj 	    -- Model
111111111111111111111111111111111111111111111111111111111111111111111111111111111111111111
1                            1 1                          1 1                            1
1                            1 1                          1 1                            1
1                            1 1                          1 1                            1
1                            1 1                          1 1                            1
1                                                                                        1
1                                                                                        1
1                                                                                        1
1                                                                                        1
1                                                                                        1
1                                                                                        1
1                     v                                                                  1
1                                                                                        1
1                                                                                        1
1                                                                                        1
1                                                                                        1
1                                                                                        1
1                                                                                        1
1                                                                                        1
1                            1 1                          1 1                            1
1                            1 1                          1 1                            1
1                            1 1                          1 1                            1
1                            1 1                          1 1                            1
11111                      1111111                      1111111                      11111
1                            1 1                          1 1                            1
1                            1 1                          1 1                            1
1                            1 1                          1 1                            1
1                            1 1                          1 1                            1
1                                                                                        1
1                                                                                        1
1                                                                                        1
1                                                                                        1
1                                                                                        1
1                                                                                        1
1                                                                                        1
1                                                                                        1
1                                                                                        1
1                                                                                        1
1                                                                                        1
1                                                                                        1
1                                                                                        1
1                                                                                        1
1                            1 1                          1 1                            1
1                            1 1                          1 1                            1
1                            1 1                          1 1                            1
1                            1 1                          1 1                            1
11111                      1111111                      1111111                      11111
1                            1 1                          1 1                            1
1                            1 1                          1 1                            1
1                            1 1                          1 1                            1
1                            1 1                          1 1                            1
1                                                                                        1
1                                                                                        1
1                                                                                        1
1                                                                                        1
1                                                                                        1
1                                                                                        1
1                                                                                        1
1                                                                                        1
1                                                                                        1
1                                                                                        1
1                                                                                        1
1                                                                                        1
1                                                                                        1
1                                                                                        1
1                            1 1                          1 1                            1
1                            1 1                          1 1                            1
1                            1 1                          1 1                            1
1                            1 1                          1 1                            1
111111111111111111111111111111111111111111111111111111111111111111111111111111111111111111