TILEMAP
71 57                           -- Size of tile map in tiles
20 15                           -- Size of room
10 -7.5 18.1                    -- Camera Center
17 14                           -- Camera Movement
5 6 0                           -- Player First CheckPoint
3                               -- Style
11111111111111111111111111111111111111111111111111111111111111111111111
1      D          n                 1                                 1
1                 n                 1                                 1
1          f      n                 1                                 1
1                 n                 1                                 1
1                 n                 1                                 1
1                 n                 1                                 1
1R                n                L1                                 1
1                 y                 1                                 1
1                 y                 1                                 1
1                 y                 1                                 1
1                 y                 1                                 1
1                 y                 1                                 1
1                 y    U            1                                 1
11111111111111111111111111111111111111111111111111111111111111111111111
                                    1                                 1
                                    1                                 1
                                    1                                 1
                                    1                                 1
                                    1                                 1
                                    1                                 1
 |                v      xxx        1                                 1
                         xcx        1                                 1
                         xxx        1               v                 1
                                    1                                 1
                                    1                                 1
                                   11                                 1
                                  111                                 1
1111111      111111111111111111111111               111111       111111
 111         111111111111111111111111               111111       111111
 111          1111111111111      1111       h       1111         111111
 111          111111111111        111               111           11111
 111           11111111            11               11             1111
 111            111111             11               1               111
 111                                1               1                11
 111                                1               1                11
 111                                1               1       f        11
 1111                               1               1                11
 111111                      v      1               11              111
 11111111                           1               11              111
 1111111111                         1               1111           1111
 111111111111111111                 1               11111       1111111
111111111111111111111111111111    111        h      1111111111111111111
                 111111111        111111            1                 0
                 11111            111111            1                 0
                 11111           1111111            1                 0
                 1111           11111111            1                 0
                 1111           1111111             1                 0
                 1111   xxx     1111111             1                 0
                 11111  xcx     111111              1                 0
                 11111  xxx      1111              11                 0
                 111111                            11                 0
                 1111111                          111                 0
                 1111111                         1111                 0
                 111111111                      11111                 0
                 11111111111      ssssssss     111111                 0
                 111111111111111111111111111111111111000000000000000000