TILEMAP
80 60 							-- Size of tile map in tiles
10 10 							-- Tile size & block size
models/cube10_border.obj 	-- Tilesheet
2 2 								-- Number of tiles in tilesheet
11111111111111111111111111111111111111111111111111111111111111111111111111111111111111111111111111111111111111111111111111111111
1                              11                              11                              11                              1
1                              11                              11                              11                              1
1                              11                              11                              11                              1
1                              11                              11                              11                              1
1                              11                              11                              11                              1
1                              11                              11                              11                              1
1                              11                              11                              11                              1
1                              11                              11                              11                              1
1                              11                              11                              11                              1
1                              11                              11                              11                              1
1                              11                              11                              11                              1
1                              11                              11                              11                              1
1                              11                              11                              11                              1
1                              11                              11                              11                              1
1                              11                              11                              11                              1
1                              11                              11                              11                              1
1                              11                              11                              11                              1
1                              11                              11                              11                              1
1                              11                              11                              11                              1
1                              11                              11                              11                              1
1                              11                              11                              11                              1
1                              11                              11                              11                              1
1                              11                              11                              11                              1
1                              11                              11                              11                              1
1                              11                              11                              11                              1
1                              11                              11                              11                              1
1                              11                              11                              11                              1
1                              11                              11                              11                              1
1                              11                              11                              11                              1
1                              11                              11                              11                              1
11111111111111111111111111111111111111111111111111111111111111111111111111111111111111111111111111111111111111111111111111111111
11111111111111111111111111111111111111111111111111111111111111111111111111111111111111111111111111111111111111111111111111111111
1                              11                              11                              11                              1
1                              11                              11                              11                              1
1                              11                              11                              11                              1
1                              11                              11                              11                              1
1                              11                              11                              11                              1
1                              11                              11                              11                              1
1                              11                              11                              11                              1
1                              11                              11                              11                              1
1                              11                              11                              11                              1
1                              11                              11                              11                              1
1                              11                              11                              11                              1
1                              11                              11                              11                              1
1                              11                              11                              11                              1
1                              11                              11                              11                              1
1                              11                              11                              11                              1
1                              11                              11                              11                              1
1                              11                              11                              11                              1
1                              11                              11                              11                              1
1                              11                              11                              11                              1
1                              11                              11                              11                              1
1                              11                              11                              11                              1
1                              11                              11                              11                              1
1                              11                              11                              11                              1
1                              11                              11                              11                              1
1                              11                              11                              11                              1
1                              11                              11                              11                              1
1                              11                              11                              11                              1
1                              11                              11                              11                              1
1                              11                              11                              11                              1
1                              11                              11                              11                              1
11111111111111111111111111111111111111111111111111111111111111111111111111111111111111111111111111111111111111111111111111111111
11111111111111111111111111111111111111111111111111111111111111111111111111111111111111111111111111111111111111111111111111111111
1                              11                              11                              11                              1
1                              11                              11                              11                              1
1                              11                              11                              11                              1
1                              11                              11                              11                              1
1                              11                              11                              11                              1
1                              11                              11                              11                              1
1                              11                              11                              11                              1
1                              11                              11                              11                              1
1                              11                              11                              11                              1
1                              11                              11                              11                              1
1                              11                              11                              11                              1
1                              11                              11                              11                              1
1                              11                              11                              11                              1
1                              11                              11                              11                              1
1                              11                              11                              11                              1
1                              11                              11                              11                              1
1                              11                              11                              11                              1
1                              11                              11                              11                              1
1                              11                              11                              11                              1
1                              11                              11                              11                              1
1                              11                              11                              11                              1
1                              11                              11                              11                              1
1                              11                              11                              11                              1
1                              11                              11                              11                              1
1                              11                              11                              11                              1
1                              11                              11                              11                              1
1                              11                              11                              11                              1
1                              11                              11                              11                              1
1                              11                              11                              11                              1
1                              11                              11                              11                              1
11111111111111111111111111111111111111111111111111111111111111111111111111111111111111111111111111111111111111111111111111111111
11111111111111111111111111111111111111111111111111111111111111111111111111111111111111111111111111111111111111111111111111111111
1                              11                              11                              11                              1
1                              11                              11                              11                              1
1                              11                              11                              11                              1
1                              11                              11                              11                              1
1                              11                              11                              11                              1
1                              11                              11                              11                              1
1                              11                              11                              11                              1
1                              11                              11                              11                              1
1                              11                              11                              11                              1
1                              11                              11                              11                              1
1                              11                              11                              11                              1
1                              11                              11                              11                              1
1                              11                              11                              11                              1
1                              11                              11                              11                              1
1                              11                              11                              11                              1
1                              11                              11                              11                              1
1                              11                              11                              11                              1
1                              11                              11                              11                              1
1                              11                              11                              11                              1
1                              11                              11                              11                              1
1                              11                              11                              11                              1
1                              11                              11                              11                              1
1                              11                              11                              11                              1
1                              11                              11                              11                              1
1                              11                              11                              11                              1
1                              11                              11                              11                              1
1                              11                              11                              11                              1
1                              11                              11                              11                              1
1                              11                              11                              11                              1
1                              11                              11                              11                              1
11111111111111111111111111111111111111111111111111111111111111111111111111111111111111111111111111111111111111111111111111111111