TILEMAP
71 57                           -- Size of tile map in tiles
20 15                           -- Size of room
10 -49.5 18.1                    -- Camera Center
17 14                           -- Camera Movement
5 6 0                           -- Player First CheckPoint
3 models/cube10.obj 	        -- Style (0 = original, 1 = water, 2 = box, 3 = mario, 4 = minecraft)
11111111111111111111111111111111111111111111111111111111111111111111111
1111u              n                                         y        1
1111u              n                                                 L1
1111u              n                                                  1
1111u          t1111                                                  1
1111u          t1111R                                                 1
1111u 1        t1111               V       V        V                 1
1111u          t1111      xxx      n       y        n                 1
1111u          t1111      xcx                                         1
1111u          t1111      xxx                                         1
1111u        1 t1111                                             nnnnn1
1111u        1 t1111R                                            n    1
1111u          t1111                                             n k  1
1111u          t1111                   U        U            y   n    1
1111u 1        t1111111111111111111111111111111111111111111111111111111
1111u 1        t1111                                                   
1111u          t1111                                                   
1111u          t1111                                                   
1111u          t1111                                                   
1111u          t1111                                                   
1111u 1      1 t1111                                                   
1111u 1      1 t1111                                                   
1111u 1      1 t1111                                                   
1111u          t1111                                                   
1111u          t1111                                                   
11111111    11111111                                                   
11111111    11111111                                                   
11111111    11111111                                                   
11111111    11111111111111111111111111111111111111111111111111111111111
111111                           1111             11   1              1
111111                           1111             11   1              1
111111        1111               1111                                 1
111111        1111               1111                        xxx      1
1    6   xxx  1111               1111                        xcx      1
1    7   xcx  1111v              1111                        xxx      1
1 f  8   xxx  1111               1111             11   1              1
1    7        1111               1111             11 o 1              1
1    9        1111               1111      h      11111111111111111 m 1
111111                                            11111111111111111 m 1
111111                                            11111111111111111 m 1
1111111111111111111111111111111111111111111111111111111111111111111 m 1
                                              111111111111111111111 m 1
                                             t111111111111111111111 m 1
                                               s  s 1 s  s  s  s 1  m  
                          111111111                 1            1  m  
                          1   1   1                t1u           s  m  
    r                     1 o 1   1                 1               m  
  11111                   1   1   1                t1u              m  
  1                                                 1               m  
  1$lllllllllllllllllllllllllllllllllllllll         s            r  m  
  1                                                              1  m  
  11111                   1   1   1                             t1  m  
                          1   1   1                              1  m  
                          1   1 o 1                             t1  m  
                          111111111                 r            1  m  
                                               r  r 1 r  r  r  r 1  m  
                                             t1111111111111111111111111