TILEMAP
90 70                           -- Size of tile map in tiles
32 24                           -- Size of room
16 -35 29                       -- Camera Center
29 23                           -- Camera Movement
1 34 0                          -- Player First CheckPoint
1                               -- Style
                                                                                          
                                                                                          
                                         1111111111111111111111111111111111111111111      
             111111                      1                       s     sss      sss1      
            11    11                     1u                                        1      
           11      11                    1u                                        1      
           1        1111111111111111111  1                                         1      
           1                          1  1              11111111                   1      
           1   f                      1  1              1      1                   1      
           1        111111111111u     1  1              1      1                   1      
           11      11          1u     1  1              1      1        xxx        1      
            11    11           1      1  1             t1      1        xcx       t1      
             111111            1      1  1             t1      1        xxx       t1      
                               1      1  1              1      1                  t1      
                               1      1  1              1      1                   1      
                               1      1111      h       1      1rr            rrr  1      
     1111111111111111111111    1                        1      111111111 m 111111111      
     1                    1    1                        1              1 m 1              
     1                    1    1                        1              1 m 1              
     1 k                  1    11111111111111111111111111              1 m 1              
     1                    1                                            1 m 1              
     1111111111  1111111111                                              m                
              1  1                                                       m                
              1  1                                                       m              11
              1  1                                                       m               1
              1  1                                                       m              O1
              1  1                                                       m               1
              1  1                    11111111111111                     m               1
              1  1                    1ssssssssssss1O                    m               1
        1111111  1111111              1      -     1                     m               1
        1              1              1            1                     m               1
        1              1              1            1                     m              O1
        1              1              1            1                     m               1
111111111              1111111111111111    xxx     1                     m               1
1$                     y                   xcx     1O                    m               1
1                      y                   xxx     1                     m               1
1111111112jjjjjjqjjjjj31111111111111111            1                     m               1
        1              1              1            1                     m              O1
        1              1              1            1                     m               1
        1 rrr        rr1              1            1                     m               1
        1111111  1111111              1            1                     m               1
              1  1                    1   h        1                     m               1
              1  1                    1rrrrrrrrr   1                     m               1
              1  1                    11111111111  1                     m               1
              1  1                              1  1                     m               1
              1  1                              1  1                     m               1
111111111111111  111111111111111                1  1                     m              11
1       1     1  1             1                1  1                     m                
1       1     1  1             1                1  1                     m                
1  111  1111  1  1  11111111   1    1111111111111  11111111              m                
1  1       1  1  1         1   1    1     sss            t1              m                
1  1       1  1  1         1   1    1                    t1              m                
1  111111  1     1  1  11111   1    1                   11111111111      m                
1       1  1     1  1  1   1   1    1u                           t1      m                
1       1  1111  1  1  1   1   1    1u                           t1      m                
1    1  1     1     1  1       1    1                   11111111111      m                
1    1  1     1     1  1       1    1         xxx        t1              m                
1  111  1111  1  1111  111111111    1         xcx        t1              m                
1  1       1  1  1             1    1         xxx      v t1              m                
1  1       1  1  1             1    1                    t1              m                
1  1  111111     111111111111y 1    1                   11111111111      m                
1  1       1     1             1    1u                                   m                
1  1       1111  1             1    1u                                   m                
1  1111  111  1  1 y111111111111    1                   11111111111      m                
1     1       1  1             1    1                    t1              m                
1     1       1111             1    1     rrr            t1              m                
1  1111  111111 D1111111  111111    11111111111111111111111              m                
1                              1                                         m                
1        n                     1                                        rrr               
11111111111111111111111111111111                                        111               