TILEMAP
90 70                           -- Size of tile map in tiles
32 24                           -- Size of room
16 -12 29                       -- Camera Center
29 23                           -- Camera Movement
1 34 0                          -- Player First CheckPoint
10                              -- Number of models
1 models/cube10.obj             -- Model for basic block
f models/cube10_test.obj        -- Model for final block
k models/key.obj                -- Model for keys
d models/door.obj               -- Model for doors
l models/hline3.obj             -- Model for horizontal lines
m models/vline3.obj             -- Model for vertical lines
s models/template_spike.obj     -- Model for spike
o models/test.obj               -- Model for ball spike
c models/checkpoint.obj         -- Model for checkpoint
C models/checkpoint2.obj        -- Model for checkpoint 2
                             1111111111111111111111111111111111111111111111111111111111111
                             1 1                          1 1                            1
                             1 1                          1 1                            1
             111111          1 1                          1 1                            1
            11    11                                      1 1                            1
           11      11                                                                    1
           1        111111111111                                                         1
           1               d                                                             1
           1   f           d                                                             1
           1        111111111111                                                         1
           11      11                                                                    1
            11    11                                                                     1
             111111                                                                      1
                                                                                         1
                                                                                         1
                                                                                         1
     1111111111111111111111                                                              1
     1   k     k     k    1                                                              1
     1                    1                                                              1
     1                   k1                                                              1
     1                    1                                                              1
     1111111111  1111111111  1 1                          1 1                            1
              1  1           1 1                          1 1                            1
              1  1           1 1                        1111111                      11111
              1  1           1 1                          1 1                            1
              1  1           1 1                          1 1                            1
              1  1           1 1                          1 1                            1
              1  1           1 1                          1 1                            1
              1  1             1                                                         1
        1111111  1111111       1                                                         1
        1s             1       1                                                         1
        1              1       1                                                         1
        1              1       1                                                         1
111111111              111111111                                                         1
1                                                                                        1
1                                                                                        1
111111111              111111111                                                         1
        1              1       1                                                         1
        1              1       1                                                         1
        1              1       1                                                         1
        1111111  1111111       1                                                         1
              1  1             1                                                         1
              1  1           1 1                          1 1                            1
              1  1           1 1                          1 1                            1
              1  1           1 1                          1 1                            1
              1  1           1 1                          1 1                            1
111111111111111  11111111111111111                      1111111                      11111
1       1     1  1             1                          1 1                            1
1       1     1  1             1                          1 1                            1
1  111  1111  1  1  11111111   1                          1 1                            1
1  1       1  1  1  1     11   1                          1 1                            1
1  1       1  1  1       111   1                                                         1
1  111111  1     1      1111   1                                                         1
1  1    1  1     1  1  11111   1                                                         1
1       1  1111  1  1  1111   11                                                         1
1       1     1  1  1  111    11                                                         1
1  111  1     1     1  1     111                                                         1
1  1    1111  1     1      11111                                                         1
1  1       1  1  1111    1111111                                                         1
1  1       1  1  1     111111111                                                         1
1  11111   1     1    1111  1111                                                         1
1   1      1     1  11111     11                                                         1
1   1      1111  1  111        1                                                         1
1   111  111111  1        111  1                                                         1
1     1  111111dd11     111    1                                                         1
1     1  11111    1111111     11                          1 1                            1
1   111        k            111                           1 1                            1
1                         111                             1 1                            1
1   1111111111    111111111                               1 1                            1
11111        111111            11111111111111111111111111111111111111111111111111111111111